"a" = (/turf/space,/area/space)
"b" = (/turf/simulated/wall/r_wall,/area/AIsattele)
"c" = (/obj/structure/lattice,/turf/space,/area/space)
"d" = (/obj/structure/computerframe,/turf/simulated/floor/plating/airless,/area/AIsattele)
"e" = (/obj/machinery/teleport/station,/turf/simulated/floor/plating/airless,/area/AIsattele)
"f" = (/obj/machinery/teleport/hub,/turf/simulated/floor/plating/airless,/area/AIsattele)
"g" = (/obj/item/weapon/shard{icon_state = "medium"},/turf/simulated/floor/plating/airless,/area/AIsattele)
"h" = (/turf/simulated/floor/plating/airless,/area/AIsattele)
"i" = (/obj/structure/rack,/obj/item/clothing/gloves/color/yellow,/turf/simulated/floor/plating/airless,/area/AIsattele)
"j" = (/obj/structure/grille,/obj/structure/window/reinforced,/obj/structure/window/reinforced{dir = 8},/obj/structure/window/reinforced{dir = 1},/turf/simulated/floor/plating/airless,/area/AIsattele)
"k" = (/obj/structure/window/reinforced{dir = 4},/obj/structure/window/reinforced{dir = 1},/obj/structure/window/reinforced,/obj/structure/grille,/turf/simulated/floor/plating/airless,/area/AIsattele)
"l" = (/obj/item/weapon/stock_parts/cell,/turf/simulated/floor/plating/airless,/area/AIsattele)
"m" = (/obj/effect/decal/cleanable/dirt,/turf/simulated/floor/plating/airless,/area/AIsattele)
"n" = (/obj/effect/decal/cleanable/robot_debris/old,/turf/simulated/floor/plating/airless,/area/AIsattele)
"o" = (/obj/effect/spawner/lootdrop/crate_spawner,/turf/simulated/floor/plating/airless,/area/AIsattele)
"p" = (/obj/machinery/door/airlock/external,/turf/simulated/floor/plating/airless,/area/AIsattele)
"q" = (/obj/effect/decal/cleanable/dirt,/obj/item/device/flashlight,/turf/simulated/floor/plating/airless,/area/AIsattele)
"r" = (/obj/effect/decal/cleanable/dirt,/obj/item/device/radio/beacon,/turf/simulated/floor/plating/airless,/area/AIsattele)
"s" = (/obj/machinery/portable_atmospherics/canister/air,/turf/simulated/floor/plating/airless,/area/AIsattele)
"t" = (/obj/structure/grille,/obj/structure/window/reinforced,/obj/structure/window/reinforced{dir = 4},/obj/structure/window/reinforced{dir = 1},/turf/simulated/floor/plating/airless,/area/AIsattele)
"u" = (/obj/effect/decal/cleanable/blood/old,/turf/simulated/floor/plating/airless,/area/AIsattele)
"v" = (/obj/effect/decal/cleanable/oil,/turf/simulated/floor/plating/airless,/area/AIsattele)
"w" = (/obj/item/weapon/shard,/obj/item/weapon/electronics/apc,/turf/simulated/floor/plating/airless,/area/AIsattele)
"x" = (/obj/structure/closet,/turf/simulated/floor/plating/airless,/area/AIsattele)
"y" = (/obj/item/weapon/storage/toolbox/electrical{pixel_x = 1; pixel_y = -1},/turf/simulated/floor/plating/airless,/area/AIsattele)
"z" = (/obj/structure/closet/crate,/obj/item/device/aicard,/obj/item/device/multitool,/obj/item/weapon/weldingtool,/obj/item/weapon/wrench,/obj/item/weapon/circuitboard/teleporter,/turf/simulated/floor/plating/airless,/area/AIsattele)
"A" = (/obj/structure/reagent_dispensers/fueltank,/turf/simulated/floor/plating/airless,/area/AIsattele)
"B" = (/obj/structure/lattice,/turf/space,/area/AIsattele)
"C" = (/obj/structure/girder,/turf/simulated/floor/plating/airless,/area/AIsattele)

(1,1,1) = {"
aaaaaabbbbbca
aaaccbbdefbba
acccbbghhhibb
aajkbhlmhnmob
ccphphqnrhhsb
aajtbsuhvhwxb
acccbbhhmhybb
aaaccbbzhAbba
aaaaaabbBhCca
aaaaaacccacaa
aaaaaaacaaaaa
aaaaaaaaccaaa
"}
