"a" = (/turf/space,/area/space)
"b" = (/turf/simulated/mineral/random,/area/space)
"c" = (/turf/simulated/floor/plating/asteroid,/area/space)
"d" = (/turf/simulated/mineral/random/high_chance,/area/space)

(1,1,1) = {"
aaabba
aabbca
abbdcc
bbddcc
bddddc
bddddc
bbdbbc
abbbba
abbbaa
aabaaa
"}
