"aa" = (/turf/space,/area/space)
"ab" = (/turf/simulated/wall/mineral/clown,/area/template/Clown)
"ac" = (/obj/structure/window/reinforced/fulltile,/obj/structure/grille,/turf/simulated/floor/plating,/area/template/Clown)
"ad" = (/obj/machinery/computer,/turf/simulated/floor/plasteel/blueyellow,/area/template/Clown)
"ae" = (/obj/structure/bed/chair/comfy/lime{dir = 1},/turf/simulated/floor/plasteel/blueyellow,/area/template/Clown)
"af" = (/obj/structure/bed/chair/comfy/lime{dir = 1},/obj/item/weapon/stamp/clown,/turf/simulated/floor/plasteel/blueyellow,/area/template/Clown)
"ag" = (/obj/machinery/computer,/obj/item/weapon/card/data/clown,/turf/simulated/floor/plasteel/blueyellow,/area/template/Clown)
"ah" = (/obj/structure/bed/chair/comfy/lime{dir = 1},/mob/living/simple_animal/hostile/retaliate/clown,/turf/simulated/floor/plasteel/blueyellow,/area/template/Clown)
"ai" = (/obj/machinery/light,/turf/simulated/floor/plasteel/blueyellow,/area/template/Clown)
"aj" = (/turf/simulated/floor/plasteel/blueyellow,/area/template/Clown)
"ak" = (/obj/machinery/door/airlock/clown,/turf/simulated/floor/plasteel/blueyellow,/area/template/Clown)
"al" = (/obj/machinery/door/poddoor{id = "cloongunleft"; name = "Orbital Bomber Door"},/turf/simulated/floor/plating,/area/template/Clown)
"am" = (/obj/machinery/mass_driver{dir = 8; id = "cloongunleft"},/obj/structure/window/reinforced{dir = 4; pixel_x = 0},/obj/machinery/portable_atmospherics/canister/toxins,/obj/structure/window/reinforced{color = "#008000"; dir = 1},/turf/simulated/floor/plating{icon_state = "warnplate"; dir = 8},/area/template/Clown)
"an" = (/obj/machinery/button/massdriver{id = "cloongunleft"; name = "Mass Driver"; pixel_x = -25; pixel_y = 25},/turf/simulated/floor/plasteel/blueyellow,/area/template/Clown)
"ao" = (/obj/machinery/button/massdriver{id = "cloongunright"; name = "Mass Driver"; pixel_x = 25; pixel_y = 25},/turf/simulated/floor/plasteel/blueyellow,/area/template/Clown)
"ap" = (/obj/machinery/mass_driver{dir = 4; id = "cloongunright"},/obj/structure/window/reinforced{dir = 8},/obj/machinery/portable_atmospherics/canister/toxins,/obj/structure/window/reinforced{color = "#008000"; dir = 1},/turf/simulated/floor/plating{icon_state = "warnplate"; dir = 8},/area/template/Clown)
"aq" = (/obj/machinery/door/poddoor{id = "cloongunright"; name = "Orbital Bomber Door"},/turf/simulated/floor/plating,/area/template/Clown)
"ar" = (/obj/machinery/conveyor/auto{dir = 1},/obj/machinery/portable_atmospherics/canister/toxins,/obj/structure/window/reinforced{dir = 4; pixel_x = 0},/obj/machinery/light{dir = 8},/turf/simulated/floor/plasteel/blueyellow,/area/template/Clown)
"as" = (/obj/machinery/conveyor/auto{dir = 1},/obj/machinery/portable_atmospherics/canister/toxins,/obj/structure/window/reinforced{dir = 8},/obj/machinery/light{dir = 4; icon_state = "tube1"},/turf/simulated/floor/plasteel/blueyellow,/area/template/Clown)
"at" = (/obj/machinery/door/window/eastleft,/obj/machinery/conveyor/auto{dir = 1},/obj/machinery/portable_atmospherics/canister/toxins,/turf/simulated/floor/plasteel/blueyellow,/area/template/Clown)
"au" = (/obj/machinery/door/window/westright,/obj/machinery/conveyor/auto{dir = 1},/obj/machinery/portable_atmospherics/canister/toxins,/turf/simulated/floor/plasteel/blueyellow,/area/template/Clown)
"av" = (/obj/structure/window/reinforced{dir = 8},/obj/structure/window/reinforced,/obj/structure/window/reinforced{dir = 1; layer = 2.9},/obj/machinery/power/emitter/energycannon{active = 0; dir = 8; req_access = null},/obj/structure/cable{icon_state = "0-4"; d2 = 4},/turf/simulated/floor/plating,/area/template/Clown)
"aw" = (/obj/structure/bed/chair/comfy/lime{dir = 8},/obj/structure/cable{d1 = 4; d2 = 8; icon_state = "4-8"; pixel_y = 0},/mob/living/simple_animal/hostile/retaliate/clown,/turf/simulated/floor/plasteel/blueyellow,/area/template/Clown)
"ax" = (/obj/structure/cable{d1 = 2; d2 = 8; icon_state = "2-8"; tag = ""},/turf/simulated/floor/plasteel/blueyellow,/area/template/Clown)
"ay" = (/obj/structure/bed/chair/comfy/lime,/turf/simulated/floor/plasteel/blueyellow,/area/template/Clown)
"az" = (/obj/structure/bed/chair/comfy/lime,/obj/machinery/light{dir = 1},/turf/simulated/floor/plasteel/blueyellow,/area/template/Clown)
"aA" = (/obj/machinery/light{dir = 1},/turf/simulated/floor/plasteel/blueyellow,/area/template/Clown)
"aB" = (/obj/structure/cable{d1 = 2; d2 = 4; icon_state = "2-4"},/turf/simulated/floor/plasteel/blueyellow,/area/template/Clown)
"aC" = (/obj/structure/bed/chair/comfy/lime{dir = 4},/obj/structure/cable{d1 = 4; d2 = 8; icon_state = "4-8"; pixel_y = 0},/mob/living/simple_animal/hostile/retaliate/clown,/turf/simulated/floor/plasteel/blueyellow,/area/template/Clown)
"aD" = (/obj/structure/window/reinforced{dir = 4; pixel_x = 0},/obj/structure/window/reinforced,/obj/structure/window/reinforced{dir = 1; layer = 2.9},/obj/machinery/power/emitter/energycannon{active = 0; dir = 4; req_access = null},/obj/structure/cable{d2 = 8; icon_state = "0-8"},/turf/simulated/floor/plating,/area/template/Clown)
"aE" = (/obj/structure/cable{d1 = 1; d2 = 2; icon_state = "1-2"},/turf/simulated/floor/plasteel/blueyellow,/area/template/Clown)
"aF" = (/obj/structure/table,/obj/item/weapon/reagent_containers/food/snacks/breadslice/banana,/obj/item/weapon/reagent_containers/food/snacks/breadslice/banana,/obj/item/weapon/reagent_containers/food/snacks/grown/banana,/obj/item/weapon/reagent_containers/food/snacks/store/bread/banana,/turf/simulated/floor/plasteel/blueyellow,/area/template/Clown)
"aG" = (/obj/item/clothing/shoes/clown_shoes/banana_shoes,/obj/item/clothing/gloves/color/rainbow/clown,/turf/simulated/floor/plasteel/blueyellow,/area/template/Clown)
"aH" = (/obj/structure/statue/bananium/clown,/turf/simulated/floor/plasteel/blueyellow,/area/template/Clown)
"aI" = (/obj/item/toy/figure/clown,/turf/simulated/floor/plasteel/blueyellow,/area/template/Clown)
"aJ" = (/obj/structure/bed/chair/comfy/lime{dir = 8},/obj/structure/cable{d1 = 4; d2 = 8; icon_state = "4-8"; pixel_y = 0},/turf/simulated/floor/plasteel/blueyellow,/area/template/Clown)
"aK" = (/obj/structure/cable{d1 = 1; d2 = 2; icon_state = "1-2"},/obj/structure/cable{d1 = 2; d2 = 4; icon_state = "2-4"},/obj/structure/cable{d1 = 2; d2 = 8; icon_state = "2-8"; tag = ""},/turf/simulated/floor/plasteel/blueyellow,/area/template/Clown)
"aL" = (/obj/structure/cable{d1 = 4; d2 = 8; icon_state = "4-8"; pixel_y = 0},/turf/simulated/floor/plasteel/blueyellow,/area/template/Clown)
"aM" = (/obj/machinery/door/airlock/clown,/obj/structure/cable{d1 = 4; d2 = 8; icon_state = "4-8"; pixel_y = 0},/turf/simulated/floor/plasteel/blueyellow,/area/template/Clown)
"aN" = (/obj/item/weapon/bikehorn,/obj/item/weapon/cartridge/clown,/obj/item/clothing/mask/gas/clown_hat,/obj/structure/cable{d1 = 4; d2 = 8; icon_state = "4-8"; pixel_y = 0},/turf/simulated/floor/plasteel/blueyellow,/area/template/Clown)
"aO" = (/obj/structure/cable{icon_state = "0-4"; d2 = 4},/obj/structure/cable{d2 = 8; icon_state = "0-8"},/obj/machinery/power/apc{dir = 3; name = "Honk Frigate APC"; pixel_y = 24},/turf/simulated/floor/plasteel/blueyellow,/area/template/Clown)
"aP" = (/obj/structure/bed/chair/comfy/lime{dir = 4},/obj/structure/cable{d1 = 4; d2 = 8; icon_state = "4-8"; pixel_y = 0},/turf/simulated/floor/plasteel/blueyellow,/area/template/Clown)
"aQ" = (/obj/machinery/light{dir = 4; icon_state = "tube1"},/turf/simulated/floor/plasteel/blueyellow,/area/template/Clown)
"aR" = (/obj/structure/bed,/obj/item/weapon/bedsheet/clown,/obj/item/weapon/storage/backpack/clown,/turf/simulated/floor/plasteel/blueyellow,/area/template/Clown)
"aS" = (/obj/structure/bed,/obj/item/weapon/bedsheet/clown,/obj/item/clothing/under/rank/clown,/turf/simulated/floor/plasteel/blueyellow,/area/template/Clown)
"aT" = (/obj/structure/bed,/obj/item/weapon/bedsheet/clown,/turf/simulated/floor/plasteel/blueyellow,/area/template/Clown)
"aU" = (/obj/machinery/light{dir = 8},/turf/simulated/floor/plasteel/blueyellow,/area/template/Clown)
"aV" = (/obj/structure/cable{d1 = 2; d2 = 8; icon_state = "2-8"; tag = ""},/obj/structure/cable{d1 = 1; d2 = 2; icon_state = "1-2"},/turf/simulated/floor/plasteel/blueyellow,/area/template/Clown)
"aW" = (/obj/machinery/suit_storage_unit/clown,/turf/simulated/floor/plasteel/blueyellow,/area/template/Clown)
"aX" = (/obj/structure/cable{d1 = 1; d2 = 2; icon_state = "1-2"},/obj/structure/cable{d1 = 2; d2 = 4; icon_state = "2-4"},/turf/simulated/floor/plasteel/blueyellow,/area/template/Clown)
"aY" = (/obj/machinery/power/smes/engineering{input_level = 200000},/obj/structure/cable{icon_state = "0-4"; d2 = 4},/turf/simulated/floor/plasteel/blueyellow,/area/template/Clown)
"aZ" = (/obj/structure/cable{d1 = 1; d2 = 8; icon_state = "1-8"},/obj/structure/cable{d1 = 1; d2 = 2; icon_state = "1-2"},/turf/simulated/floor/plasteel/blueyellow,/area/template/Clown)
"ba" = (/obj/item/stack/sheet/mineral/bananium{amount = 25},/obj/structure/closet/crate,/turf/simulated/floor/plasteel/blueyellow,/area/template/Clown)
"bb" = (/obj/structure/shuttle/engine/heater,/obj/structure/window/reinforced{dir = 1},/turf/simulated/floor/plating,/area/template/Clown)
"bc" = (/obj/item/weapon/coin/clown,/obj/item/weapon/coin/clown,/obj/item/weapon/coin/clown,/obj/item/weapon/coin/clown,/obj/item/weapon/coin/clown,/obj/item/weapon/coin/clown,/obj/item/weapon/coin/clown,/obj/item/weapon/coin/clown,/obj/item/weapon/coin/clown,/obj/item/weapon/coin/clown,/obj/item/weapon/coin/clown,/obj/item/weapon/coin/clown,/obj/item/weapon/coin/clown,/obj/structure/closet/crate,/turf/simulated/floor/plasteel/blueyellow,/area/template/Clown)
"bd" = (/obj/structure/cable{d1 = 1; d2 = 2; icon_state = "1-2"},/obj/structure/cable{d1 = 1; d2 = 4; icon_state = "1-4"; tag = "90Curve"},/turf/simulated/floor/plasteel/blueyellow,/area/template/Clown)
"be" = (/obj/machinery/power/smes/engineering{input_level = 200000},/obj/structure/cable{d2 = 8; icon_state = "0-8"},/turf/simulated/floor/plasteel/blueyellow,/area/template/Clown)
"bf" = (/obj/structure/shuttle/engine/heater,/obj/structure/window/reinforced{dir = 1},/obj/machinery/power/terminal{icon_state = "term"; dir = 1},/obj/structure/cable{icon_state = "0-4"; d2 = 4},/turf/simulated/floor/plating,/area/template/Clown)
"bg" = (/obj/structure/shuttle/engine/heater,/obj/structure/window/reinforced{dir = 1},/obj/structure/cable{d1 = 1; d2 = 8; icon_state = "1-8"},/turf/simulated/floor/plating,/area/template/Clown)
"bh" = (/obj/structure/shuttle/engine/propulsion,/turf/simulated/floor/plating,/area/template/Clown)
"bi" = (/obj/structure/shuttle/engine/heater,/obj/structure/window/reinforced{dir = 1},/obj/structure/cable{d1 = 1; d2 = 4; icon_state = "1-4"},/turf/simulated/floor/plating,/area/template/Clown)
"bj" = (/obj/structure/shuttle/engine/heater,/obj/structure/window/reinforced{dir = 1},/obj/machinery/power/terminal{icon_state = "term"; dir = 1},/turf/simulated/floor/plating,/area/template/Clown)

(1,1,1) = {"
aaaaaaaaabacacacacacacabaaaaaaaa
aaaaaaaaacadaeafaeaeagacaaaaaaaa
aaaaaaaaacahaiajajaiahacaaaaaaaa
aaaaaaaaabababakakabababaaaaaaaa
aaaaaaaaaaalamanaoapaqaaaaaaaaaa
aaaaaaaaaaabarajajasabaaaaaaaaaa
aaaaaaaaaaabatajajauabaaaaaaaaaa
abababababababakakababakabababab
avawaxajabayazajajaAakajabaBaCaD
abajaEajabaFaFajaGaHabababaEaIab
avaJaKaLaMaLaLaLaLaNaOaMaLaKaPaD
abajaEaQabaRaSaTaTaTaTabaUaEajab
avawaVajabaWaWaWaWaWaWabajaXaCaD
abaYaZbaabababbbbbabababbcbdbeab
abbfbgbbabaaabbhbhabaaabbbbibjab
abbhbhbhabaaaaaaaaaaaaabbhbhbhab
"}
