"a" = (/turf/space,/area/space)
"b" = (/turf/space,/turf/simulated/wall/shuttle{dir = 8; icon_state = "diagonalWall3"},/area/template/syndicate_scout_ship)
"c" = (/obj/structure/grille,/obj/structure/window/reinforced/fulltile,/obj/machinery/door/poddoor/shutters{id = "syndiscouttemplate"; name = "blast shutters"},/turf/simulated/floor/wood,/area/template/syndicate_scout_ship)
"d" = (/turf/space,/turf/simulated/wall/shuttle{dir = 1; icon_state = "diagonalWall3"},/area/template/syndicate_scout_ship)
"e" = (/turf/simulated/floor/plasteel/shuttle/red{name = "Shuttle floor"},/obj/structure/sign/nosmoking_1{pixel_x = -6; pixel_y = 6},/turf/simulated/wall/shuttle{dir = 4; icon_state = "diagonalWall3"},/area/template/syndicate_scout_ship)
"f" = (/obj/machinery/computer,/turf/simulated/floor/plasteel/shuttle/red{name = "Shuttle floor"},/area/template/syndicate_scout_ship)
"g" = (/obj/structure/bed/chair/comfy/black{dir = 1; icon_state = "comfychair"; name = "pilot's chair"; tag = "icon-comfychair (NORTH)"},/mob/living/simple_animal/hostile/syndicate/melee/space,/turf/simulated/floor/plasteel/shuttle/red{name = "Shuttle floor"},/area/template/syndicate_scout_ship)
"h" = (/obj/structure/bed/chair/comfy/black{dir = 1; icon_state = "comfychair"; name = "pilot's chair"; tag = "icon-comfychair (NORTH)"},/mob/living/simple_animal/hostile/syndicate/ranged/space,/turf/simulated/floor/plasteel/shuttle/red{name = "Shuttle floor"},/area/template/syndicate_scout_ship)
"i" = (/turf/simulated/floor/plasteel/shuttle/red{name = "Shuttle floor"},/obj/structure/sign/nosmoking_1{pixel_x = 6; pixel_y = 6},/turf/simulated/wall/shuttle{icon_state = "diagonalWall3"},/area/template/syndicate_scout_ship)
"j" = (/obj/machinery/teleport/hub,/turf/simulated/floor/plasteel/shuttle/red{name = "Shuttle floor"},/area/template/syndicate_scout_ship)
"k" = (/turf/simulated/floor/plasteel/shuttle/red{name = "Shuttle floor"},/area/template/syndicate_scout_ship)
"l" = (/obj/machinery/computer/med_data,/turf/simulated/floor/plasteel/shuttle/red{name = "Shuttle floor"},/area/template/syndicate_scout_ship)
"m" = (/obj/machinery/teleport/station,/turf/simulated/floor/plasteel/shuttle/red{name = "Shuttle floor"},/area/template/syndicate_scout_ship)
"n" = (/obj/structure/table/abductor,/obj/item/weapon/gun/energy/laser/retro/sc_retro,/turf/simulated/floor/plasteel/shuttle/red{name = "Shuttle floor"},/area/template/syndicate_scout_ship)
"o" = (/obj/structure/table/abductor,/turf/simulated/floor/plasteel/shuttle/red{name = "Shuttle floor"},/area/template/syndicate_scout_ship)
"p" = (/obj/machinery/computer/crew,/turf/simulated/floor/plasteel/shuttle/red{name = "Shuttle floor"},/area/template/syndicate_scout_ship)
"q" = (/obj/machinery/computer/teleporter,/turf/simulated/floor/plasteel/shuttle/red{name = "Shuttle floor"},/area/template/syndicate_scout_ship)
"r" = (/obj/structure/table/abductor,/obj/item/weapon/storage/toolbox/syndicate,/turf/simulated/floor/plasteel/shuttle/red{name = "Shuttle floor"},/area/template/syndicate_scout_ship)
"s" = (/obj/machinery/computer/security,/turf/simulated/floor/plasteel/shuttle/red{name = "Shuttle floor"},/area/template/syndicate_scout_ship)
"t" = (/turf/simulated/floor/plasteel/shuttle/red{name = "Shuttle floor"},/turf/simulated/wall/shuttle{dir = 4; icon_state = "diagonalWall3"},/area/template/syndicate_scout_ship)
"u" = (/turf/simulated/floor/plasteel/shuttle/red{name = "Shuttle floor"},/turf/simulated/wall/shuttle{icon_state = "diagonalWall3"},/area/template/syndicate_scout_ship)
"v" = (/turf/simulated/wall/shuttle{icon_state = "wall3"},/area/template/syndicate_scout_ship)
"w" = (/obj/machinery/button/door{id = "syndiscouttemplate"; name = "remote shutter control"; pixel_x = -25; pixel_y = 25; req_access_txt = "0"},/turf/simulated/floor/plasteel/shuttle/red{name = "Shuttle floor"},/area/template/syndicate_scout_ship)
"x" = (/obj/structure/dispenser/oxygen,/turf/simulated/floor/plasteel/shuttle/red{name = "Shuttle floor"},/area/template/syndicate_scout_ship)
"y" = (/obj/machinery/suit_storage_unit/empty_open,/turf/simulated/floor/plasteel/shuttle/red{name = "Shuttle floor"},/area/template/syndicate_scout_ship)
"z" = (/obj/machinery/portable_atmospherics/canister/oxygen,/turf/simulated/floor/plasteel/shuttle/red{name = "Shuttle floor"},/area/template/syndicate_scout_ship)
"A" = (/obj/machinery/button/door{id = "syndiscouttemplate"; name = "remote shutter control"; pixel_x = 25; pixel_y = 25; req_access_txt = "0"},/turf/simulated/floor/plasteel/shuttle/red{name = "Shuttle floor"},/area/template/syndicate_scout_ship)
"B" = (/obj/machinery/door/airlock/external,/turf/simulated/floor/plasteel/shuttle/red{name = "Shuttle floor"},/area/template/syndicate_scout_ship)
"C" = (/obj/structure/shuttle/engine/heater,/obj/structure/window/reinforced{dir = 1; layer = 2.9},/turf/simulated/floor/plating/airless{dir = 9; icon_state = "warnplate"},/area/template/syndicate_scout_ship)
"D" = (/obj/structure/shuttle/engine/heater,/obj/structure/window/reinforced{dir = 1; layer = 2.9},/turf/simulated/floor/plating/airless{dir = 1; icon_state = "warnplate"},/area/template/syndicate_scout_ship)
"E" = (/obj/structure/shuttle/engine/heater,/obj/structure/window/reinforced{dir = 1; layer = 2.9},/turf/simulated/floor/plating/airless{dir = 5; icon_state = "warnplate"},/area/template/syndicate_scout_ship)
"F" = (/obj/structure/sign/vacuum{pixel_x = -32},/obj/item/weapon/storage/secure/safe{pixel_x = 32},/turf/simulated/floor/plasteel/shuttle/red{name = "Shuttle floor"},/area/template/syndicate_scout_ship)
"G" = (/obj/structure/shuttle/engine/propulsion{icon_state = "propulsion_l"},/turf/simulated/wall/shuttle{icon_state = "wall3"},/area/template/syndicate_scout_ship)
"H" = (/obj/structure/shuttle/engine/propulsion,/turf/simulated/wall/shuttle{icon_state = "wall3"},/area/template/syndicate_scout_ship)
"I" = (/obj/structure/shuttle/engine/propulsion{icon_state = "propulsion_r"},/turf/simulated/wall/shuttle{icon_state = "wall3"},/area/template/syndicate_scout_ship)
"J" = (/obj/structure/sign/vacuum{pixel_x = 32},/obj/structure/fireaxecabinet{pixel_x = -30; pixel_y = 0},/turf/simulated/floor/plasteel/shuttle/red{name = "Shuttle floor"},/area/template/syndicate_scout_ship)

(1,1,1) = {"
aabccccdaa
abefghfida
acjkkkklca
acmknokpca
acqkorksca
btkkkkkkud
vwkxyyzkAv
vBvCDDEvBv
vFvGHHIvJv
vBvaaaavBv
"}
