"a" = (/turf/space,/area/space)
"b" = (/turf/simulated/floor/plasteel/cult/airless,/area/space)
"c" = (/obj/effect/rune/wall{density = 1; dir = 9; icon = 'icons/effects/blood.dmi'; icon_state = "tracks"},/turf/simulated/floor/plasteel/cult/airless,/area/space)
"d" = (/obj/effect/rune/wall{density = 1; dir = 4; icon = 'icons/effects/blood.dmi'; icon_state = "tracks"},/turf/simulated/floor/plasteel/cult/airless,/area/space)
"e" = (/obj/effect/rune/wall{density = 1; dir = 5; icon = 'icons/effects/blood.dmi'; icon_state = "tracks"},/turf/simulated/floor/plasteel/cult/airless,/area/space)
"f" = (/obj/effect/rune/wall{density = 1; dir = 2; icon = 'icons/effects/blood.dmi'; icon_state = "tracks"},/turf/simulated/floor/plasteel/cult/airless,/area/space)
"g" = (/obj/effect/rune/wall{density = 1; dir = 1; icon = 'icons/effects/blood.dmi'; icon_state = "tracks"},/turf/simulated/floor/plasteel/cult/airless,/area/space)
"h" = (/obj/effect/gibspawner/human,/obj/effect/rune/narsie,/mob/living/simple_animal/hostile/faithless,/turf/simulated/floor/plasteel/cult/airless,/area/space)
"i" = (/obj/effect/rune/wall{density = 1; dir = 6; icon = 'icons/effects/blood.dmi'; icon_state = "tracks"},/turf/simulated/floor/plasteel/cult/airless,/area/space)
"j" = (/obj/effect/rune/wall{density = 1; dir = 10; icon = 'icons/effects/blood.dmi'; icon_state = "tracks"},/turf/simulated/floor/plasteel/cult/airless,/area/space)
"k" = (/turf/simulated/floor/plasteel/cult/airless,/turf/simulated/wall/cult,/area/space)
"l" = (/turf/simulated/floor/plating/lava,/area/space)
"m" = (/turf/simulated/floor/plasteel/cult,/turf/simulated/wall/cult,/area/space)
"n" = (/obj/structure/mineral_door/sandstone,/turf/simulated/floor/plasteel/cult,/area/space)
"o" = (/turf/simulated/floor/plasteel/cult,/area/space)
"p" = (/obj/effect/rune/manifest,/turf/simulated/floor/plasteel/cult,/area/space)
"q" = (/obj/structure/cult/forge,/turf/simulated/floor/plating/lava,/area/space)
"r" = (/obj/effect/rune/raise_dead,/turf/simulated/floor/plasteel/cult,/area/space)
"s" = (/obj/structure/cult/pylon,/turf/simulated/floor/plasteel/cult,/area/space)
"t" = (/obj/structure/cult/talisman,/turf/simulated/floor/plasteel/cult,/area/space)
"u" = (/obj/effect/rune/sacrifice,/turf/simulated/floor/plasteel/cult,/area/space)
"v" = (/obj/structure/cult/tome,/turf/simulated/floor/plasteel/cult,/area/space)
"w" = (/obj/structure/table/wood,/obj/item/candle/infinite{icon_state = "candle3_lit"; lit = 1; luminosity = 2},/turf/simulated/floor/plasteel/cult,/area/space)
"x" = (/obj/item/weapon/tome,/obj/structure/table/wood,/turf/simulated/floor/plasteel/cult,/area/space)
"y" = (/obj/effect/rune/narsie,/obj/effect/gibspawner/human,/obj/item/weapon/veilrender/lesserveilrender,/mob/living/simple_animal/hostile/faithless,/turf/simulated/floor/plasteel/cult,/area/space)
"z" = (/obj/effect/rune/wall{density = 1; dir = 8; icon = 'icons/effects/blood.dmi'; icon_state = "tracks"},/turf/simulated/floor/plasteel/cult/airless,/area/space)

(1,1,1) = {"
aaaaaaaabbcdddebbaaaaaaaa
aaaaaaabbbfbbbgbbbaaaaaaa
aaaaaabbbbfbhbgbbbbaaaaaa
aaaaabbbbbfbbbgbbbbbaaaaa
aaaacdddddibbbjdddddeaaaa
aaabfkkkkkkkbkkkkkkkgbaaa
aabbfklllllmnmlllllkgbbaa
abbbfkllllmopomllllkgbbba
bbbbfkllqoorsrooqllkgbbbb
bbbbfkllootouovoollkgbbbb
cdddiklmovmwxwmtomlkjddde
fbbbbkmorowoooworomkbbbbg
fbhbbbnpsuxoyoxuspnbbbhbg
fbbbbkmorowoooworomkbbbbg
jzzzeklmotmwxwmvomlkczzzi
bbbbfklloovouotoollkgbbbb
bbbbfkllqoorsrooqllkgbbbb
abbbfkllllmopomllllkgbbba
aabbfklllllmnmlllllkgbbaa
aaabfkkkkkkkbkkkkkkkgbaaa
aaaajzzzzzebbbczzzzziaaaa
aaaaabbbbbfbbbgbbbbbaaaaa
aaaaaabbbbfbhbgbbbbaaaaaa
aaaaaaabbbfbbbgbbbaaaaaaa
aaaaaaaabbjzzzibbaaaaaaaa
"}
