"a" = (/turf/simulated/wall/r_wall,/area/derelict)
"b" = (/mob/living/simple_animal/hostile/temmie,/turf/simulated/floor/bluegrid,/area/derelict)
"c" = (/mob/living/simple_animal/hostile/venus_human_trap,/turf/simulated/floor/bluegrid,/area/derelict)
"d" = (/mob/living/simple_animal/hostile/viscerator,/turf/simulated/floor/bluegrid,/area/derelict)
"e" = (/mob/living/simple_animal/hostile/zombie,/turf/simulated/floor/bluegrid,/area/derelict)

(1,1,1) = {"
aaaaaaaaaa
abbbbbbbba
abccccccba
abcddddcba
abcdeedcba
abcdeedcba
abcddddcba
abccccccba
abbbbbbbba
aaaaaaaaaa
"}
