"a" = (/turf/space,/area/space)
"b" = (/turf/simulated/wall/mineral/clown,/area/template/Clown)
"c" = (/obj/structure/window/reinforced/fulltile,/obj/structure/grille,/turf/simulated/floor/plating,/area/template/Clown)
"d" = (/obj/machinery/computer,/turf/simulated/floor/plasteel/blueyellow,/area/template/Clown)
"e" = (/obj/structure/stool/bed/chair/comfy/lime{dir = 1},/turf/simulated/floor/plasteel/blueyellow,/area/template/Clown)
"f" = (/obj/structure/stool/bed/chair/comfy/lime{dir = 1},/obj/item/weapon/stamp/clown,/turf/simulated/floor/plasteel/blueyellow,/area/template/Clown)
"g" = (/obj/machinery/computer,/obj/item/weapon/card/data/clown,/turf/simulated/floor/plasteel/blueyellow,/area/template/Clown)
"h" = (/obj/structure/stool/bed/chair/comfy/lime{dir = 1},/mob/living/simple_animal/hostile/retaliate/clown,/turf/simulated/floor/plasteel/blueyellow,/area/template/Clown)
"i" = (/turf/simulated/floor/plasteel/blueyellow,/area/template/Clown)
"j" = (/obj/machinery/door/airlock/clown,/turf/simulated/floor/plasteel/blueyellow,/area/template/Clown)
"k" = (/obj/machinery/door/poddoor{id = "cloongunleft"; name = "Orbital Bomber Door"},/turf/simulated/floor/plating,/area/template/Clown)
"l" = (/obj/machinery/mass_driver{dir = 8; id = "cloongunleft"},/obj/structure/window/reinforced{dir = 4; pixel_x = 0},/obj/machinery/portable_atmospherics/canister/toxins,/obj/structure/window/reinforced{color = "#008000"; dir = 1},/turf/simulated/floor/plating{icon_state = "warnplate"; dir = 8},/area/template/Clown)
"m" = (/obj/machinery/button/massdriver{id = "cloongunleft"; name = "Mass Driver"; pixel_x = -25; pixel_y = 25},/turf/simulated/floor/plasteel/blueyellow,/area/template/Clown)
"n" = (/obj/machinery/button/massdriver{id = "cloongunright"; name = "Mass Driver"; pixel_x = 25; pixel_y = 25},/turf/simulated/floor/plasteel/blueyellow,/area/template/Clown)
"o" = (/obj/machinery/mass_driver{dir = 4; id = "cloongunright"},/obj/structure/window/reinforced{dir = 8},/obj/machinery/portable_atmospherics/canister/toxins,/obj/structure/window/reinforced{color = "#008000"; dir = 1},/turf/simulated/floor/plating{icon_state = "warnplate"; dir = 8},/area/template/Clown)
"p" = (/obj/machinery/door/poddoor{id = "cloongunright"; name = "Orbital Bomber Door"},/turf/simulated/floor/plating,/area/template/Clown)
"q" = (/obj/machinery/conveyor/auto{dir = 1},/obj/machinery/portable_atmospherics/canister/toxins,/obj/structure/window/reinforced{dir = 4; pixel_x = 0},/turf/simulated/floor/plasteel/blueyellow,/area/template/Clown)
"r" = (/obj/machinery/conveyor/auto{dir = 1},/obj/machinery/portable_atmospherics/canister/toxins,/obj/structure/window/reinforced{dir = 8},/turf/simulated/floor/plasteel/blueyellow,/area/template/Clown)
"s" = (/obj/machinery/door/window/eastleft,/obj/machinery/conveyor/auto{dir = 1},/obj/machinery/portable_atmospherics/canister/toxins,/turf/simulated/floor/plasteel/blueyellow,/area/template/Clown)
"t" = (/obj/machinery/door/window/westright,/obj/machinery/conveyor/auto{dir = 1},/obj/machinery/portable_atmospherics/canister/toxins,/turf/simulated/floor/plasteel/blueyellow,/area/template/Clown)
"u" = (/obj/structure/window/reinforced{dir = 8},/obj/structure/window/reinforced,/obj/structure/window/reinforced{dir = 1; layer = 2.9},/obj/machinery/power/emitter/energycannon{active = 0; dir = 8; req_access = null},/obj/structure/cable{icon_state = "0-4"; d2 = 4},/turf/simulated/floor/plating,/area/template/Clown)
"v" = (/obj/structure/stool/bed/chair/comfy/lime{dir = 8},/obj/structure/cable{d1 = 2; d2 = 8; icon_state = "2-8"},/mob/living/simple_animal/hostile/retaliate/clown,/turf/simulated/floor/plasteel/blueyellow,/area/template/Clown)
"w" = (/obj/structure/stool/bed/chair/comfy/lime,/turf/simulated/floor/plasteel/blueyellow,/area/template/Clown)
"x" = (/obj/structure/stool/bed/chair/comfy/lime{dir = 4},/obj/structure/cable{d1 = 2; d2 = 4; icon_state = "2-4"},/mob/living/simple_animal/hostile/retaliate/clown,/turf/simulated/floor/plasteel/blueyellow,/area/template/Clown)
"y" = (/obj/structure/window/reinforced{dir = 4; pixel_x = 0},/obj/structure/window/reinforced,/obj/structure/window/reinforced{dir = 1; layer = 2.9},/obj/machinery/power/emitter/energycannon{active = 0; dir = 4; req_access = null},/obj/structure/cable{d2 = 8; icon_state = "0-8"},/turf/simulated/floor/plating,/area/template/Clown)
"z" = (/obj/structure/cable{d1 = 1; d2 = 2; icon_state = "1-2"; pixel_y = 0},/turf/simulated/floor/plasteel/blueyellow,/area/template/Clown)
"A" = (/obj/structure/table,/obj/item/weapon/reagent_containers/food/snacks/breadslice/banana,/obj/item/weapon/reagent_containers/food/snacks/breadslice/banana,/obj/item/weapon/reagent_containers/food/snacks/grown/banana,/obj/item/weapon/reagent_containers/food/snacks/store/bread/banana,/turf/simulated/floor/plasteel/blueyellow,/area/template/Clown)
"B" = (/obj/item/clothing/shoes/clown_shoes/banana_shoes,/obj/item/clothing/gloves/color/rainbow/clown,/turf/simulated/floor/plasteel/blueyellow,/area/template/Clown)
"C" = (/obj/structure/statue/bananium/clown,/turf/simulated/floor/plasteel/blueyellow,/area/template/Clown)
"D" = (/obj/item/toy/figure/clown,/obj/structure/cable{d1 = 1; d2 = 2; icon_state = "1-2"; pixel_y = 0},/turf/simulated/floor/plasteel/blueyellow,/area/template/Clown)
"E" = (/obj/structure/stool/bed/chair/comfy/lime{dir = 8},/obj/structure/cable{d1 = 2; d2 = 8; icon_state = "2-8"},/obj/structure/cable{d1 = 1; d2 = 2; icon_state = "1-2"; pixel_y = 0},/turf/simulated/floor/plasteel/blueyellow,/area/template/Clown)
"F" = (/obj/item/weapon/bikehorn,/obj/item/weapon/cartridge/clown,/obj/item/clothing/mask/gas/clown_hat,/turf/simulated/floor/plasteel/blueyellow,/area/template/Clown)
"G" = (/obj/structure/stool/bed/chair/comfy/lime{dir = 4},/obj/structure/cable{d1 = 2; d2 = 4; icon_state = "2-4"},/obj/structure/cable{d1 = 1; d2 = 2; icon_state = "1-2"; pixel_y = 0},/turf/simulated/floor/plasteel/blueyellow,/area/template/Clown)
"H" = (/obj/structure/stool/bed,/obj/item/weapon/bedsheet/clown,/obj/item/weapon/storage/backpack/clown,/turf/simulated/floor/plasteel/blueyellow,/area/template/Clown)
"I" = (/obj/structure/stool/bed,/obj/item/weapon/bedsheet/clown,/obj/item/clothing/under/rank/clown,/turf/simulated/floor/plasteel/blueyellow,/area/template/Clown)
"J" = (/obj/structure/stool/bed,/obj/item/weapon/bedsheet/clown,/turf/simulated/floor/plasteel/blueyellow,/area/template/Clown)
"K" = (/obj/structure/stool/bed/chair/comfy/lime{dir = 8},/obj/structure/cable{d1 = 2; d2 = 8; icon_state = "2-8"},/obj/structure/cable{d1 = 1; d2 = 2; icon_state = "1-2"; pixel_y = 0},/mob/living/simple_animal/hostile/retaliate/clown,/turf/simulated/floor/plasteel/blueyellow,/area/template/Clown)
"L" = (/obj/machinery/suit_storage_unit/clown,/turf/simulated/floor/plasteel/blueyellow,/area/template/Clown)
"M" = (/obj/structure/stool/bed/chair/comfy/lime{dir = 4},/obj/structure/cable{d1 = 2; d2 = 4; icon_state = "2-4"},/obj/structure/cable{d1 = 1; d2 = 2; icon_state = "1-2"; pixel_y = 0},/mob/living/simple_animal/hostile/retaliate/clown,/turf/simulated/floor/plasteel/blueyellow,/area/template/Clown)
"N" = (/obj/machinery/power/smes/magical,/obj/structure/cable,/turf/simulated/floor/plasteel/blueyellow,/area/template/Clown)
"O" = (/obj/item/stack/sheet/mineral/bananium{amount = 25},/obj/structure/closet/crate,/turf/simulated/floor/plasteel/blueyellow,/area/template/Clown)
"P" = (/obj/structure/shuttle/engine/heater,/obj/structure/window/reinforced{dir = 1},/turf/simulated/floor/plating,/area/template/Clown)
"Q" = (/obj/item/weapon/coin/clown,/obj/item/weapon/coin/clown,/obj/item/weapon/coin/clown,/obj/item/weapon/coin/clown,/obj/item/weapon/coin/clown,/obj/item/weapon/coin/clown,/obj/item/weapon/coin/clown,/obj/item/weapon/coin/clown,/obj/item/weapon/coin/clown,/obj/item/weapon/coin/clown,/obj/item/weapon/coin/clown,/obj/item/weapon/coin/clown,/obj/item/weapon/coin/clown,/obj/structure/closet/crate,/turf/simulated/floor/plasteel/blueyellow,/area/template/Clown)
"R" = (/obj/structure/shuttle/engine/propulsion,/turf/simulated/floor/plating,/area/template/Clown)

(1,1,1) = {"
aaaabccccccbaaaa
aaaacdefeegcaaaa
aaaachiiiihcaaaa
aaaabbbjjbbbaaaa
aaaaaklmnopaaaaa
aaaaabqiirbaaaaa
aaaaabsiitbaaaaa
bbbbbbbjjbbjbbbb
uviibwwiiijibixy
bziibAAiBCbbbiDb
uEiijiiiiFijiiGy
bziibHIJJJJbiizb
uKiibLLLLLLbiiMy
bNiObbbPPbbbQiNb
bPPPbabRRbabPPPb
bRRRbaaaaaabRRRb
"}
